1 1 1 1 1 1 1 1 4 1 4 1 1 1 1
1 5 5 1 7 1 1 1 1 5 5 5 1 5 1
1 5 5 1 1 1 1 5 5 5 5 5 1 5 1
4 5 5 4 1 1 1 5 5 5 5 5 1 5 1
5 5 5 5 1 1 1 1 1 1 1 1 1 1 1
5 5 5 5 1 1 1 4 1 1 1 1 7 5 1
1 5 5 1 1 1 1 5 5 1 1 1 1 1 1
1 4 4 1 1 1 5 5 5 5 1 1 5 5 1
5 1 1 1 1 1 1 5 5 1 1 1 5 5 1
5 5 5 5 5 5 5 2 1 1 1 1 1 1 1