1 1 4 5 5 5 5 4 5 5 5 5 4 1 3
5 1 1 1 5 5 5 5 5 5 5 1 1 1 5
5 1 1 1 1 5 5 5 5 5 1 1 1 1 5
5 1 1 6 1 1 5 5 5 1 1 1 1 1 5
1 1 1 1 1 1 1 5 1 1 1 1 1 1 1
1 1 4 1 1 1 1 4 1 1 1 1 4 1 1
1 1 5 1 1 1 5 5 5 1 1 1 5 1 1
1 5 5 5 1 1 1 1 1 1 1 5 5 5 1
5 5 5 5 5 1 5 1 5 1 5 5 5 5 5
5 5 5 5 5 1 5 2 5 1 5 5 5 5 5