6 1 1 1 1 4 1 4 1 4 1 1 1 1 3
5 5 1 1 1 1 5 1 5 1 1 1 4 4 1
5 1 1 1 1 1 5 1 5 1 1 1 5 5 1
1 4 4 1 1 1 5 1 5 1 1 5 5 5 5
5 5 5 5 1 1 5 1 5 1 1 5 5 5 5
5 5 5 5 1 1 1 1 1 1 1 1 5 5 1
1 5 5 1 1 5 1 1 1 5 1 1 5 5 1
1 5 5 1 1 5 1 1 1 5 1 1 1 1 1
5 1 1 1 1 5 1 1 1 5 1 1 1 1 5
5 5 1 1 1 5 1 2 1 5 1 1 1 5 5