-1
KEY 
1=dirt 
2=hero 
3=monster
4=money bag
5=gem

-1
111141111111111
111551151111411
141551151111111
111553153111555
111551151111555
111551151111555
111111414111111
111111111111111
511111111111115
551111111111155

OR 2D array boolean 
-1
011111111110000
011111111110111
011111111110111
011111111110111
011111111110111
001111111110111
101111111110111
100001111110111
111101111110111
111100000000111





